100 10 30 
7 10
X-+-P-P...
..|.......
..+-F.....
..|.......
..P.......
..........
..P.......
